111111111111111
1C000010C000001
10X0001000X0001
1000C00000X0001
100000100000XX1
100000100C000E1
10X0001000000X1
10000010000X001
100PX000C00X001
111111111111111