11111
1P001
10C11
10XX1
1E111
11111