11111111111
1000C0000E1
10001110001
10C00011001
100C0001101
10000C00111
1X00X000P01
11111111111